..........
.S........
........*.
.......*..
********..
..........
..........
..........
........D.
..........